111111111111111111111111111111
1P00000000000000C000000000C001
100000000110000000100000000001
100000111100000000011100000011
10000000000000C000000000000001
111111000000000000000000111001
10000000000000000000E000100001
100000C00000000000001000100001
100000111000000000000000100001
10000000000001111110000000C001
111C00000000000000100000000001
11110000000000C000111111000001
10C111110000000000000000C00001
100000000000000000000000000001
111111111111111111111111111111
