1111111111111
10C1000000001
1000011111N01
1P0N11E000001
1111111111111
