1111111111111
1PCEN11111111
1111111111111