111111111111111111111
1P0000000000000001E01
1000000C0010000111111
10111111111001110C001
101C00000000000000001
100000000000001100001
111111111111111111111
