111111111111111111111
100000000000000000E01
1000000C0010000110101
101000111110011100001
101000000000000000001
100000000000001100P01
111111111111111111111
