111111111111111111111111111111
1P00000000000000C000000000C001
100000000110000001100000000001
10C000111100000000011111111011
1000001C000000C000000000000001
111111000000000000000000111001
1C0000000000111000000000100001
100000C000001110N00010E0100001
101111111000111000000111100001
10100000000011111110000000C001
101C000000000000C0100000000001
101100000000000000111111000001
10C1111100000C0000000001111C01
100000000000000000000000000001
111111111111111111111111111111
